       .*=@@@@@@=-.                                                                                    
    -#:           .=+.                                                                                 
   *+               .@-                                                                                
   @     .#####.     =*:::@                                                                            
   @     *#####@     @.   =:                                                                           
   =-     *###+.    :=    -=                                                                           
   .@              =:     .@                                                                           
    :=                     @                                                                           
     .+@+:.  .:#-          @                                                                           
          =-..             @@==++++=##@@@@@@@+@-                                                       
          =.                                  +-        :@@@@@@@@@@@+::::::::****.                     
          =.                                  @.        **         -@=          =.                     
          +*              .#. .:*****:----@-  .------.....         .#+          =.                     
          .@               =.             **                                    =.                     
           @.              @.             **  @*--------**         .@=-         =.                     
           =.             -=              *:  +-        **         .@=-         @.                     
           =.             -+              *:  +-        :#@@@@@@@@=*-=*--   .   @                      
           =.             :* =@@@@@@@@==*::.  +-                       .@  :=                          
           .:**++@@@@@@@@@+- @.               =-          ....*+==*.#@=+*   ...=-                      
                             @.               =.          +:     .@.#          -=          --*++++++.  
                             +:........-:**:::=:          -###    .            -=         -=        @  
                                         .--.             -##@    +*#         =#=         **        @. 
                                     #:.   .@---:***+++++-.#@@@@@@#-@        .##=        :=        .@. 
                                     =-                 +-          @         @#=       =#  =#######=  
                                     :*     -#@@@=+++@. +:          =-         **      =###    #####=. 
                                     :+      =-      ** -=          ++*:.      =-    .#####+        ** 
                          ...-+@@===+*-      :+      -+ .@             .@  =:--   .@+        @######*  
                         .@                  .@      -+  @@@@@@@@@@@====+  @.     .=      #########=   
                          @. :#@==#           :+      @.......     .......:@      .##=       #####@    
      =-..-::::::::-.-=   =. -=   =-          .#::************:-..  :##@           @######=    @@##=*  
      =-              @.  **  @.  **                             .     -@+         .#########       +: 
      =-              =.  -=  @.  :+           :@@@@@@@@@@@@@@=:         +:         .#########      *: 
      *+-.        ....=.  :*  **  :+           +:            .@          :#+@@@@#*   .@####         *: 
           ....@  @.      :*  +:  ....                       =-           :+    :+     @#    ########. 
    *=======@@@@  +@==++**=*  +:-.  ++****:----:+=@@+-       =.                 :*   +.    ##########: 
    @##+                        .@  +-              +-       +:           :+    **...    ############: 
    @###                        .@  +-              +- @+****:-          -#.           ##############* 
    =###@@@====+. +@@@@@@@@. #===+  =.              *: =-     .+:      -=#@@@@+***------:+=@#########= 
               +- =.      @. @      @               -+ =-      @ @*+@+#                                
            -*:@: =.      +: @.    .@               -+ @.      @.#=*#.                                 
            *:      -@  .=.  -++@  .@               -+ @.      :*                                      
            *:       @  .@      @  .@               -#=#.      :*                                      
            :+       @  .@      @  .@                          :*                                      
             .......--  .@=+++++*  -+               -=.@       :*                                      
                                   :++***:----:+=@@+-+-+***:-++:*                                                              